User,Total Coding Days,Total Commits,Files Changed,Lines Added,Lines Removed,Net Lines Changed
karthick0211,1,2,7,29,17,12
brianjdunn,1,1,6,27,15,12
Susil-Arul,1,1,2,80,2,78
ThivyaGopal93,1,1,9,27,5,22
mchandirasekaran,3,3,1,3,3,0
harshith-hobsons,2,3,2,2,2,0
Brajender-Kaur,3,3,14,144,21,123
nivethithanara,1,1,2,32,1,31
jeetendra97,1,1,5,19,97,-78
dsandner,1,1,3,3,11,-8
